10
120
2;4;8;16;32;64;128
1,1,M;2,3,F;3,2,M;8,1,F
15;7
GGGGGGGGGGGGGGG
GPPPTTPPPTTPPPG
GGGPGGGGPGGPGPG
GGGPGGGGPGGPGPG
GPPPGGPPPGGPGPG
GPGGGGGGPGGPGPG
GPPPTTPPPTTPPPG
GGGGGGGGGGGGGGG